9.795398935194430834e+00
1.047310353785064407e+01
1.003804240478468834e+01
1.049774894656571256e+01
1.042690160509120645e+01
1.027234617389921567e+01
1.037006910927383707e+01
9.975575509737813817e+00
1.026075417417722768e+01
9.515811875169966072e+00
1.059475155965255766e+01
9.725628031018233699e+00
9.947384008350782736e+00
1.053730343555654869e+01
1.029961103453680238e+01
1.038904926926232974e+01
1.057560966186952101e+01
1.008940313611213213e+01
1.056350465370862324e+01
1.015197715593921046e+01
9.732008712709452780e+00
1.003018358496745854e+01
9.936870724924915521e+00
1.039966768978635869e+01
1.038702879022960879e+01
1.012694416532598396e+01
1.005923478449582831e+01
9.619669866631785027e+00
9.480351265362559232e+00
1.002338608743164450e+01
1.059365925715497347e+01
1.014346015099431675e+01
1.049554811894858908e+01
9.549151562731021059e+00
1.023427784468143287e+01
1.022925292219549931e+01
9.862815993804346704e+00
1.053559864301983673e+01
1.039824727215782119e+01
1.048767591182703818e+01
9.436866674770323371e+00
1.057555772358616508e+01
1.018130416367493218e+01
1.054962118860915865e+01
9.319331093155875934e+00
1.062063052872851365e+01
1.060630503516995304e+01
9.572663410738476486e+00
1.081101066406638012e+01
9.783844896684543713e+00
